0010000000000000000000000000000000000000
0111111111111100001111111000000000000101
0010000000000100001000001000000000000101
0010000000000111111000001000000000000101
0010000000000000000000001000000000000101
0010000000000111111000001000000000000101
0010000000000100000000001000000000000101
0000000000000100000000001000000000000101
0000000000000100000000001111111111110110
0000000000000100000000000000000000000110